#S#########
#   #     #
# # # # ###
# # # #   #
### ##### #
# # #     #
# # ### ###
#   # #   #
# ### # # #
#       # #
#######E###