#S#########
# #   #   #
# ### ### #
#   #     #
# ### ### #
#     #   #
# #########
# #   #   #
# # ### # #
#       # #
#########E#