#S###################
#   # # #   #       #
# ### # ### # # ### #
#           # #   # #
# # # ########### ###
# # #         #     #
##### ######### # ###
# # # #         #   #
# # # # ####### ### #
#   # #   # #   #   #
# # # # ### # ### # #
# #       #   # # # #
############### ### #
#     # # # # # #   #
# ##### # # # # ### #
#         #         #
# ### # ### # #######
#   # #     #     # #
# # # ### # # ### # #
# # # #   # # #     #
###############E#####