#S###################
#           #     # #
### # # ### # ##### #
#   # #   # # #     #
# # # ####### ##### #
# # # #             #
# ############### # #
#   #     #     # # #
### # # # ### # # ###
# #   # #     # #   #
# # # # ######### ###
#   # #           # #
# ######### ### ### #
#   # #     #       #
##### ##### # ### ###
#       #   #   #   #
### # ### ####### # #
#   # # # #     # # #
### # # ### # ### ###
#   #       #       #
###################E#