#S#############################
#       # #         #     #   #
# ##### # # # ### ### ### ### #
# # #     # #   # # # #   # # #
### ### # # # ### # # ### # # #
# #     #   # #     #   # #   #
# ### ##### ### ##### ### ### #
#         #   #     #   #     #
### ### ##### ##### # # # #####
#   # #   #       #   # #     #
# ### # ##### ##### ### # ### #
# #   # #   #   #   #   #   # #
### # # ### # ####### # # # # #
# # #     # #   #     # # # # #
# ##### # # # ### ### # # ### #
# #     # #     # #   # # #   #
# ### # ##### # # ### # ### # #
# #   #   #   # # #   #   # # #
# ### # # # # ##### ##### # ###
#   # # # # # # #     # # # # #
# # # ### # # # # ##### # # # #
# # # #   # #   # #   #   # # #
# ##### ########### # # # # # #
#     #   #     #   #   # #   #
# ### ### ### ##### ### # # ###
#   #   # # #     #   # # # # #
# ### # # # ### ############# #
# #   # #   #           #     #
# ### ##### ### # # # ### ### #
# #             # # #     #   #
#############################E#