#S#############################
#     #       # #   #   # # # #
# # ### # ### # # ### # # # # #
# #     #   # #     # #       #
### ### # # ### ### # ##### # #
#   #   # # # #   # #     # # #
# ########### # # ### # ### ###
#   #   # # #   #   # # # # # #
# # # ### # # ####### ### ### #
# # #     #     # # # #   # # #
# # # ##### # ### # # ### # # #
# #   # # # #   # #   #   # # #
# ### # # # ##### # ##### # # #
# # #     # #       #     #   #
# # # ##### ### ##### # ##### #
# #       #         # #   #   #
####### ### # ### # ### ### # #
#       #   # #   # #       # #
### ### # ########### ### # ###
#     #   # #         #   # # #
####### ### # # ######### # # #
#   #   #   # #     # #   #   #
### # # # # ### ### # #########
#     #   # #   # #     #     #
##### # # ### ### # ### ##### #
#     # # # # #     #   #     #
# # ### # # # # # ### ### # # #
# # #   # #   # # # # # # # # #
### # ### ### ##### # # # # ###
#   # #         #         #   #
#############################E#