#S#######################################
#     # #   #   #   #       # #   #     #
### # # ### # # # ### ### ### ### ##### #
#   #         # #   # #       #   #     #
##### ######### # # # ### # # ### # #####
#   #       # # # #   #   # # #         #
### # # ### # # # ########### ######### #
# #   # # # # # #   # #     #       #   #
# ### ### # # ##### # # # ######### ### #
# #   #           #     # #   # #   #   #
# ### ### ### ### # ### ##### # ####### #
#     #     #   # # #         #     #   #
# ##### # ######### ####### # # ####### #
#   #   #           #   # # #       #   #
### # ##### ##### ### ### # ### ##### ###
#   # #   # #   #       #     #     #   #
# ####### # ### # ############# ### ### #
#   # # #       #       #     #   # #   #
# ### # ### # # ##### # ##### ### ##### #
# #         # # # #   #     # #     #   #
### # # # ### ### ##### # ### # ##### # #
# # # # # #       # #   #   # #   #   # #
# ### ####### ##### ### ##### # # ### # #
#   #       # #       #   # #   # #   # #
# # ### # ####### # # # ### ### # # ### #
# # # # # # #     # #   #     # #   #   #
# ### # ### ####### ### # ######### #####
#     # #     #   # #     #   #         #
# ### ##### ### # # # # # # # ### ##### #
#   #   #   #   # # # # #   # # # #     #
# # # ##### # ##### ### ##### # ### ### #
# # #   # #     # #   #   # #   #   #   #
# ####### ### # # ##### ### ##### ##### #
#   #   #     # # #   #       # #     # #
# ### ######### # # # ### ##### # #######
# #       #   #   # #           #   # # #
# ##### # # # # # ### ### ####### ### # #
#       #   # # #       #     #   #   # #
##### ##### # # # ####### ### ### # ### #
#         # #   #     #     # #         #
#######################################E#