#S#######################################
#     #                             #   #
# ####### ### ##### ### ### ##### # ### #
# #   # # #   #   #   # # #     # #     #
# # # # ####### ### ### # # ### #########
#   # #         #   #     # #           #
# ######### ### ##### # ####### ### ### #
# #   # # #   #       #     # #   # # # #
# ### # # # ############### # ### ### ###
#           # # #       #   #   # #     #
### ####### # # # ### ##### ### # # ### #
#       # #   #   #     #   #   #   #   #
# ##### # ### ### ### ### # # ######### #
#     # #     #   #   #   #           # #
# # # # ########### # # ####### # # # ###
# # # # #         # # #   # # # # # #   #
### ##### ######### ### # # # ####### ###
# # #   #         #     #     #   #   # #
# # # ### # ### ##### # # ### # # ##### #
#     #   #   # #     # #   # # #       #
### ### ####### ####### ##### # ##### ###
#   #   #     # #   #       # # #       #
# ### # ##### # ### # # ### ### # #######
#     # # #     #     # # #     #       #
# # ##### ### ### # ### # # ######### # #
# #   #   #   # # # #     # #   #     # #
##### ### ##### # # # ### # ### # ### ###
#     # #   #   # # #   # # #   # #     #
# ##### ### ### ######### # ### # # # ###
#   # #       # # # #     # #     # # # #
### # ##### ### # # ##### ### ### ### # #
#           #     # # #     #   # # #   #
####### ### ##### # # ### ### ##### ### #
#       #     #   #         #   # #   # #
# ##### # # ##### ####### ##### # # #####
# #   # # #       #   #   #             #
# # ### ##### ####### ######### ### # ###
#     #   #   #   # # # #     #   # #   #
### ##### ### # # # # # # ####### ##### #
#       #   #   #             #   #     #
###############E#########################