#S#################################################
#       #     #   #   # #   #               #   # #
##### # # ##### ##### # ### ### # # # ### ### ### #
# #   #       #     #       #   # # #   #   #     #
# # # # ### ##### ### ####### # # # ### ### # ### #
#   # #   #         #       # # # # #     # #   # #
# ##### ######### # # # ### ####### # ### ####### #
# # #   #     #   #   # #   #       # #     #   # #
### ### ### ########### ####### # ##### # # # ### #
#   #   #       #       #   #   # # #   # #       #
# ##### # # # # ####### # ##### # # # ### ##### # #
# #   # # # # # #   #     #     # # #   #   # # # #
# ### ####### ### ####### ####### # ##### # # ### #
# #   #   #               #   # # #   # # #   #   #
# ### ### # ### ### ####### # # ### ### ### ### # #
# #   #   # # # #     #     # # #       #     # # #
# ### ### # # # ####### ### ### # ### ##### # ### #
#   #   #   #     # #   # #     #   #   #   #   # #
### # # # ####### # ##### ### ####### # ##### # ###
#     #   #     # #   # #         #   #     # # # #
# ### ### ### ### ### # ##### ##### # ####### # # #
#   #   #   #   # #     # #       # #   #     #   #
### # ### ### ##### ### # # ##### ##### # ##### # #
#   # #     #   #     #       #   # #         # # #
### ### # ### # # ### # ####### ### # ##### # ### #
#   #   #   # # # # # # #     #           # # #   #
# # ### # ### ##### # ####### ##### ### # ##### # #
# # #   #     #   #           # #     # #   # # # #
##### ### ####### ####### ##### ####### ### # ### #
#   # #           # # #   #     # # #   # # #     #
### ### ### ### # # # ##### ### # # ##### ### # ###
#       #     # # #   #   # #   # #         # # # #
# ### ####### # ##### ### ##### # ######### ### # #
# # #   # # # #           # #     #             # #
# # ##### # ##### # ### ### ##### ### ######### # #
#   # #   #       #   # #   # # #     # #   #   # #
# # # ### ### ####### ### ### # # ##### ### # # # #
# #   # #           # #       # # #           # # #
# # ### # ### ##### # # # ### # ######### ##### # #
# # #       #   #   #   #   #         #       # # #
##### ####### ####### ####### ######### ### ##### #
# #     #       # #     #         # #   #   # #   #
# # # ##### # # # ### # ####### ### ### ##### # # #
#   # #     # # #   # #       #   #             # #
############# ### ### ### # # ### ### ### ##### # #
#   # #         # #   #   # # #   #   #     #   # #
### # ### ### ### # # ### # ### # ####### ### # ###
# #     # # #   #   # # # # #   #   # # # #   # # #
# ### ### # # # ### ### # # # # ##### # # ##### # #
#         #   #   #   #   # # #             #     #
#################################################E#