#S#################################################
#   #   #   # #   # #   # # # #             #     #
### # ##### # # ### # # # # # # ##### # # ##### ###
# #   #   #   # # #   # #         #   # #       # #
# # ### # # ### # # ####### ### ##### # # ##### # #
# #   # # # #   #       #     #   #   # # # #   # #
# # ### ### # ### ### ### # ########### # # # ### #
#           # # # #       #   # # #   # #   #   # #
# ####### # # # ############# # # ### ### # ### # #
#     #   # # #     # #     #       #   # #   #   #
# # # # ##### # ### # # ### # # # ##### # ##### ###
# # # #       # #   #   #     # #   #   #   # #   #
# ##### ####### ####### ##### # # # ### # # # ### #
#     #     # #             # # # #   #   #   #   #
# ##### ### # ### # ### ### ##### ##### # #########
#   # # #     # # #   # # #   #   #     # # #     #
### # # ### # # ### ##### ####### # ### # # ### # #
#   #   # # # # #     #   #   # # # #   #       # #
# # ##### ### # # ####### # ### ##### ########### #
# #   # #     #   #     # #     #         #       #
####### # # ##### ### # # # # ##### ### ##### # ###
#         #         # #     #   #   #       # # # #
##### # ### # ####### ### ### ### ####### # # # # #
#     #   # #       # #     #   #   # #   # # #   #
# ####### # ############# # ######### ##### # #####
#     # # # # #         # #   #       # #   # #   #
### ### ### # ##### ##### ####### ### # ### # ### #
#     # # # #   #         #     #   #       #   # #
##### # # ### ##### ####### ### # ####### ### ### #
#             # #   # #     #   # #     # # #   # #
# # ### ### # # # # # # ######### # ### ### # # # #
# # #     # #     #       #     #     #   #   # # #
### # # # # ### # ####### ##### ### ### ##### ### #
# # # # # # #   # # #       # # #     # #   # # # #
# ##### ########### # ##### # # ### # # ### ### # #
#         # #   #     #   # # # # # # # #         #
######### # # ### ### # ### # # # ### ### ##### # #
# #     #       # # #   # # #       #         # # #
# # ##### ### ### # ##### ######### # ### ### # ###
# #   #   # #   #         #     #       # #   # # #
# # # ### # # ##### ####### ####### # ### ####### #
#   #   # #   # #   #   # #         # #   # #     #
####### # ### # # ### ### ######### ##### # ### ###
#   #   # #   # #         #     # #   # #         #
### ### # ##### ############# # # # # # # ####### #
#     #           #     #   # # # # # # #   #   # #
### ### ####### # # ##### ### ### ### # # ##### # #
#         #   # #           #   #     # #   # #   #
##### ####### ### ### # ##### ### # ### ##### ### #
#           #     #   #   #       # #             #
#####################################E#############