#S###########################################################
#                     #   #       #   # #           #       #
##### ### ### # ### ##### # ####### ### ### ### ### ### ### #
#     #   #   # # # #   #   #         #   # #   #     #   # #
# # ### # # ### # ### # # # # ### # ##### # # ### ### # #####
# #   # # # # # #     # # #     # #     #   #   # #   # #   #
# ######### # ######### # # # ### ####### # ##### # # # ### #
#   # # # #         #     # #   #       # # # #   # # # #   #
### # # # # ### ### ####### # ### ####### ### # # ##### # # #
#   #   # # #   #   # #   # #   #   #   # #   # #   # # # # #
### # ### # # # ### # ### # ######### # # ### ##### # # # ###
# #   #   # # # # #     # #       #   # # #     #     #     #
# # ##### ### # # # ### # ### ##### ####### ####### # ### # #
#   #       # # # #   # # #   # #     #   # #   #   #   # # #
# ### ########### # # # # ### # # # ##### # # ##### ### # ###
# # #       #       # # #     #   #   # #   #   #     #   # #
### ### # ######### ### ##### ####### # # # # ######### ### #
#   #   #   #     #   # #           #     #   #     # #     #
# # ##### # # ### # # ##### ####### # ### ### ### ### # #####
# # #     # # # #   #         # # # # # # # #   #     #     #
# ### ### ### # ##### # # # # # # ### # # # ### # ##### # ###
# #     # # #       # # # # #           # # #     #   # #   #
# # ### ### # ##### ####### ### ### # # ### ### # # # # ### #
#   # # #     #     #         # #   # #   #     # # # # # # #
### # ### ######### # # ### ##### # ### # ### ##### ### # ###
#     #   #   #     # # #       # #   # # # # #   #   #   # #
# ##### ### # ####### ########### # ### # # # ### # ##### # #
#     # # # #   #         # # #   # #   # #         #       #
# ##### # # ##### ### # ### # # ####### # ######### ##### ###
#   #   #     # #   # # #             # #     # # # #   # # #
# ### ### # ### ### # # # # ### ####### ### ### # ### # # # #
#   #   # #     # # # # # # # #     #   # #   # #   # #     #
# ##### ####### # ######### # ### ### ### ##### ### # # #####
#   #   # #     #   # #   #   #     #   #   #     # # #   # #
### # ### # ##### ### ### ### # ### # ##### ##### # # ##### #
#       # # #   #   #   #   # # #   #               # #   # #
# ##### # # ### ### # ### ################### ### ### # ### #
#   # #     # #     # #   #           #     # # # #     #   #
##### # ##### # ### # # # ##### # ##### ####### ####### ### #
# #     # #   # #       #       # #     # #     #           #
# ##### # # ##### ##### ####### # ### # # # ####### # #######
#     # # #   # # #     #       #     #       #   # # #   # #
# ### # # # # # # ########### ### ##### ##### ### ### # # # #
#   #       #     #   #       #       # # #         #   #   #
### ####### # # ### # # # # ######### ### ##### ### ### ### #
# #     #   # # # # #   # #   #   #   #       #   # #   #   #
# # ### # ### # # # ############# ##### ##### # ### ### ### #
#   #   # # # # # # #     # #       #   # # #   #   # # #   #
##### ### # ### # ### ##### # ### ##### # # ### ##### ### ###
#       #   #     # #       # # # # #     #   #       #     #
# ####### # ####### # ### ### # ### # ### # ### ######### # #
# #     # #   # # #   #   #     #       #     #       #   # #
# ### ######### # ####### # # # # ### ####### ##### ##### ###
#   # # #     #   # #       # #   # # #       #   #     #   #
### # # ##### # ### ### ##### # ### ### # # ### ### # ### ###
#   #     #   #   #   # #   # #     #   # # # # #   #   #   #
### ### ##### # ##### ### ### ##### ##### # # # # # # # ### #
#   # #       # #     # #         # # # # #     # # # #     #
# ### # # ### # ### ### ##### # ##### # # # ####### # # #####
#       #   #     #           #         # #     #   # #     #
##########################################################E##