#S###########################################################
#   #     #                     #         # #   # #       # #
# ### ### # # # # # # ##### # # # ####### # ### # ##### ### #
#   # # # # # # # # #   # # # #   #         #   #           #
### # # # # ##### ### # # # ####### ### ### # # # # ####### #
#       # #     # #   # #       # #   # #   # #   #   #   # #
### ####### # ##### # # ### ##### # ### # # # ### ### ### # #
#       # # #     # # # # #     #   #   # #   # #   # #   # #
# # # ### # ##### ####### # ### ### ### # ### # ##### ### # #
# # # # #   #     #       # #   #     # # # #   # # # # #   #
### ### ### ##### # ### ### ### # # # # ### ### # # ### #####
#   #       #         # # #   # # # # #   #     #   #     # #
### ### ####### ### # # # ### ### # ####### # # # # ### ### #
# #     #     # #   # # #       # # #     # # #   #         #
# # ### # ########### ### # ######### ### # # # ### # # # ###
#     # #     #         # #       #     #   # # #   # # #   #
##### # ##### ####### ######### ################# ### # # # #
#   # # # #         #   #   # #     # #     #   # #   # # # #
# # # ### ##### ### # ### # # # # ### ### # # ####### ##### #
# # # # #     # #   #   # # #   #     #   #       #     #   #
# ### # # ####### # # ##### # # ############### ### # ### ###
#     #   # # #   # # # # #   #       #   #   #   # # # #   #
##### # ### # ##### ### # ####### ####### ### # ### ### # ###
#   #   #     #   # #   # # # # # #   #             #   # # #
# # ### # ##### ### # ### # # # # # ########### ####### ### #
# #   #           # #           # #       #       # #     # #
# # # ######### # # ####### # # # # # # # ### ##### # ##### #
# # # # #       # #       # # #     # # #   #   #           #
##### # # ### ####### ### # ### # ####### # ### ########### #
#           #         #   # # # #   #   # # # #   #         #
# ####### ####### # ####### # ##### ### ### # # ######### ###
#   #     # # #   # #   #   #   #   # #     # #   # #       #
######### # # # ####### # ### # # # # ##### # ##### ##### ###
#         #     #   #     # # # # #   #   # # # #     #     #
######### ### # # # # ### # ### ### # ### ### # ##### # # ###
# # #       # #   # # #     #       #   # #   #       # #   #
# # # ##### ##### ####### ### # ####### # ### # ### # # ### #
# # #     #   #       #   # # #     #   # #   #   # # #   # #
# # # # ### # ### # ####### ### ### ### # # ##### ##### ### #
#   # # #   # #   #   #   # # # #     # # #   #     #   #   #
# # # # ##### ### ### # # # # ########### ### # ##### ##### #
# #   # #   # # # #     #   # # #     # #               #   #
# ##### ### ### # ### ##### # # # ##### # ################# #
#     # #     #     # #     #   #     #   #   # #       #   #
# ######### ####### # ### # # # ### ### # # # # ##### ##### #
#   # # #   # # #   # # # # # # #       #   #       #     # #
##### # # ### # # # ### # # ### # ### ### ######### # ### # #
#         #     # # #   # #     # # # # #   #       # #     #
# ####### # ##### ### ### ### # # # ### # ### # #############
#   # #       #   #   # # # # # # # # # #   # #   #       # #
##### # ####### ##### # ### # ##### # # ### # ### # ##### # #
#       # #       # #     #   # #   #       # # #   # # #   #
### # # # # # # # # # ### ##### ### # # # ### # # ### # # # #
#   # # # # # # #     #     #         # # # # #   #       # #
### ### # ### ##### ##### ##### # ### ### # ######### ### # #
#     #   #   # # #   # # #     # #     #       #     #   # #
# ### # ##### # # # ### ##### ### ### # ### # # ######### # #
# #   #       #         #   # # # #   #   # # #       #   # #
### # # ##### ######### # ### # # ##### ### # ##### ### # # #
#   # #     # #                 # #     #   # #       # # # #
###########################################################E#