#####################################S###########################################
#         #   #     #     #     #   # #   # #     #   # #   #     #           # #
####### ##### ### ### ##### # ### # # # # # # ##### # # ### ### ### # ######### #
#   #       # #   #       # # #   #     #     #     #         # #   #   #     # #
# # # # # ### # # ####### # ##### # ####### ### # ####### # ### ### ######### # #
# # # # #     # #   #         #   # #           #     # # # #       #       #   #
### # ##### ### ##### # ### ### ########### ##### ##### # ##### ### # ### # ### #
# #     # # # #     # # #     #       # # #   # #       # #     #     # # #     #
# ####### # # ##### # ##### ########### # ### # ####### ### ####### # # #########
# #       #     #   #     #   #   #         #   # # #   #   # # #   #       # # #
# # ### ##### ### ### # # ### ### ##### # # ### # # ### ##### # ####### # # # # #
#   #     # #   # #   # # #   #   # #   # #     #       #     #   #     # #   # #
### ####### ### # # # ####### # ### ####### # # # ### # # ##### ### # ####### # #
# #         #       # # #   #         # #   # # # #   #   #     #   # #   #     #
# ##### # # ##### ##### # ############# # ### ##### # ### ### ########### ### ###
#   #   # # #         #   #   # #   #   # #       # # #       #   # #           #
# ### # ##### ### ##### ##### # # ##### ############# ####### # ### # ##### ### #
#     #     # #   # #         #     #             # # #     # #   #   #   # # # #
##### ####### ##### ### ####### ############# ### # # ### ####### ### ### # # ###
#       # #   # #   # # #       #       #       #       # #   #   #     #       #
# ####### # # # # ### # # ### ### ##### # ### # ### ### # ### # ##### ### # #####
# # #   # # #           # # #     #   #   #   # #   #           # #   # # # # # #
# # # ### ### ##### # ### # ##### # ############# ### ### # ### # # # # ### # # #
# #     #     # #   # #     #       #   #         # #   # # # #     # # #       #
# # # # ####### # ####### ### # # ### # ### # ##### # # ##### # # ##### ### ### #
# # # #   # #   #           # # #   # # #   # #       # #     # #     # #     # #
# ##### ### # ### # # ######### ####### # ##### ### ##### ##### ### # # # # # ###
#       #     #   # #   # #   # #     #       # # # # #     # # # # #   # # #   #
### # ####### # ### ### # # # # # ### ### ### # # # # ##### # # # ############# #
#   #     #   # #   #   #   # #     #   #   # # # #       #     # # #     #     #
### # ####### # ### # ### ####### # ####### ### # ### # ######### # # # # ##### #
#   #   #   #   #   #   #   #   # #       # #   #   # # #         #   # # #     #
# # # ##### # ####### ### ##### # ### ### ####### ### ### # ### ### # ### # # ###
# # # # #   #   #   # #     #       # # # #       #   # # # # #   # # # # # #   #
# ##### ### ### # ### ##### # ### ### # ##### ### # ### ### # # # # ### ### ### #
#     #         #   # # #   #   # #     # # # #     # #   # #   #   #       #   #
# # # ##### ### # ##### # ### ### ##### # # # ### ### # ### # ### # ### ### #####
# # # # #     #       # # # #   # # #   #       #       #   #   # #       #   # #
### ### # # ########### # # # ### # # # ##### ### ### ##### ### ####### # # ### #
#     #   #         # # #     #   # # # # # # #     #     #   #       # # # # # #
# # # ######### ##### # ### ### ### # ### # ##### # ### ####### ####### # ### # #
# # # #   #     #     #       # # #   # #     # # # #   # #       #   # #       #
# ### ### ### ####### # # # # # # # # # ##### # ####### # # # ####### ######### #
# #               #     # # # # #   # #   #   # #     #   # # # # #       #     #
####### ####### ####### ##### ####### # ### ### # ### ### # ### # # # # ### ### #
#             #   #   # #     # #   #   #   #   # #   #   # # #     # # #     # #
######### ##### # ### # ##### # # ### ##### ### ### # ####### # ### # # ### ### #
#       #   # # #   #     # #       #   #         # #   # #     #   # # #   # # #
# # # ### # # # ######### # # ####### ####### ##### ##### ### # # ######### # ###
# # #   # # #         #     # #   #     #     # #         # # # # #     #     # #
####### # # ##### ############# ### ####### # # # # ####### # ##### # ##### ### #
# #       # # # #     # # #       #     # # #   # #   # # #     #   #       #   #
# # ### ##### # ####### # ##### ######### ### ### ##### # ##### # ######### # ###
#   # # # # # #   #   #           #       #           #   #   # #       # #   # #
##### # # # # # ### # ##### # # ### ### ####### ##### ### # ### # ### ### ### # #
# #     #     #     #     # # #   # #   #           #       # #   #   # # #     #
# # ### ### ####### ############# # # # # ##### # # ### # # # # ####### # ### ###
# #   # #           #     # #     # # #   #   # # # #   # #     #   #   #       #
# # ######### ######### ### ### # # ### # # # # ### # ##### # ##### # ### #######
#       # #     #   # #     #   # # # # # # #   # # # # #   #     # # # #       #
### # ### # # ### ### # # ##### ##### ### ####### ### # ### ##### # # # ### ### #
#   #     # # #   #     #   #     # #       #     # # # #   #       #       #   #
##### ##### ### ##### ##### ### ### ####### # # # # ### # ######### ########### #
#   #   #       #     #   #         # # #   # # #     #   #   #     # #   #     #
# # # ##### ### # ### # # ### # # ### # # # # # # ##### # # # ####### # # # ### #
# #     # #   # #   # # #     # #     #   #   # # #     # # #   # # # # # # # # #
### # ### # # ### ####### ### # ### ######### # # ########### # # # # # ##### # #
#   #     # #       # #     # #   # #   # #   # # #   #       #   #   #         #
# ####### # # ####### # # ### # ##### # # ### ##### ##### ##### ### # ### # #####
# #       # #   #   #   # #   # #   # #   #   # #     #     # #   # #     #   # #
####### ######### ##### # ##### ### ##### ### # # # # ### ### ### ####### ##### #
#     # #         # # # #   # # #                 # # #     # #       #   #     #
# ### ### ##### ### # ##### # # ### ########### ### ######### # # ##### ### # # #
# #   # #     #     #       #     #     # # #     #             # # # #     # # #
# ### # ####### # ##### # ### ### # # # # # # ### ######### ### ### # ##### # ###
# #     #     # #   # # # # #   # # # #   #   #   # #   #   #     #   # # # # # #
### ### ### ##### ### ##### # ########### ### ##### ### ##### ### # # # # # ### #
#   #   # #       #   # #                   #   #         # # #     # # #   #   #
##### ### ### ##### ### # ####### ##### ##### ### ### ##### # # ### ### # ##### #
#                             #     #   #         #   #       #   # #           #
###################################################E#############################